red
#K#######
#X#X#X#X#
X###X###X
#########
H###H###H
#########
#########
H###H###H
X#######X
#X#####X#
####H####
##X#X#X##
#########
##H###H##
#########
#########  
##H###H##
#########
X#######X
##H###H##
HXX###XXH
#########    
#########
H#######H
#########
#########
H#######H
XX#####XX
#H#####H#
#########
#########
#H##O##H#	
XXXXXXXXX
