wood
#K#######
XXX###XX#
########X
H########
########H
#########
H########
X#######H
#X#####X#
##X###X##
########H
###XX####
#########
########H
########X
#######X#  
######X##
#####X###
####X####
###X#####
XXX######
#########    
H########
#########
####O####
H##XXX###
#########
#######XX
H########
#######H#
#########
H######H#	
XXXXXXXXX
